TYPE_OF_CANCER_ID	CANCER_NAME
aa	AggressiveAngiomyxoma
aastr	AnaplasticAstrocytoma
abc	ActivatedB-cellType
abl	AcuteBasophilicLeukemia
aca	AdrenocorticalAdenoma
acbc	AdenoidCysticBreastCancer
acc	AdrenocorticalCarcinoma
accc	AcinicCellCarcinoma
acml	AtypicalChronicMyeloidLeukemia,BCR-ABL1-
acn	AcinarCellCarcinoma,NOS
acpg	Craniopharyngioma,AdamantinomatousType
acpp	AtypicalChoroidPlexusPapilloma
acrm	AcralMelanoma
acyc	AdenoidCysticCarcinoma
adma	Adamantinoma
adnos	Adenocarcinoma,NOS
adpa	AggressiveDigitalPapillaryAdenocarcinoma
adrenal_gland	AdrenalGland
aeca	SweatGlandCarcinoma/ApocrineEccrineCarcinoma
afh	AngiomatoidFibrousHistiocytoma
afx	AtypicalFibroxanthoma
aga	AnalGlandAdenocarcinoma
agng	AnaplasticGanglioglioma
ahcd	AlphaHeavy-ChainDisease
ais	AdenocarcinomaInSitu
aitl	AngioimmunoblasticT-CellLymphoma
alal	AcuteLeukemiasofAmbiguousLineage
alcl	AnaplasticLargeCellLymphoma
alclalkn	AnaplasticLarge-CellLymphomaALKNegative
alclalkp	AnaplasticLarge-CellLymphomaALKPositive
alklbcl	ALKPositiveLargeB-CellLymphoma
aluca	AtypicalLungCarcinoid
am	AMLwithMaturation
ambl	LargeCell/AnaplasticMedulloblastoma
amkl	AcuteMegakaryoblasticLeukemia
aml	AcuteMyeloidLeukemia
amlbcrabl1	AMLwithBCR-ABL1
amlcbfbmyh11	AMLwithinv(16)(p13.1q22)ort(16;16)(p13.1;q22);CBFB-MYH11
amlcebpa	AMLwithBiallelicMutationsofCEBPA
amldeknup214	AMLwitht(6;9)(p23;q34.1);DEK-NUP214
amlgata2mecom	AMLwithinv(3)(q21.3q26.2)ort(3;3)(q21.3;q26.2);GATA2,MECOM
amlmd	AMLwithMinimalDifferentiation
amlmllt3kmt2a	AMLwitht(9;11)(p21.3;q23.3);MLLT3-KMT2A
amlmrc	AMLwithMyelodysplasia-RelatedChanges
amlnos	AML,NOS
amlnpm1	AMLwithMutatedNPM1
amlrbm15mkl1	AML(megakaryoblastic)witht(1;22)(p13.3;q13.3);RBM15-MKL1
amlrga	AMLwithRecurrentGeneticAbnormalities
amlrunx1	AMLwithMutatedRUNX1
amlrunx1runx1t1	AMLwitht(8;21)(q22;q22.1);RUNX1-RUNX1T1
amml	AcuteMyelomonocyticLeukemia
amol	AcuteMonoblastic/MonocyticLeukemia
ampca	AmpullaryCarcinoma
ampulla_of_vater	AmpullaofVater
an	AtypicalNevus
angl	AngiocentricGlioma
angs	Angiosarcoma
ankl	AggressiveNK-CellLeukemia
anm	AnaplasticMeningioma
ansc	AnalSquamousCellCarcinoma
aoast	AnaplasticOligoastrocytoma
aodg	AnaplasticOligodendroglioma
apad	AppendicealAdenocarcinoma
ape	AnaplasticEpendymoma
aplpmlrara	APLwithPML-RARA
apmf	AcutePanmyelosiswithMyelofibrosis
aptad	AtypicalPituitaryAdenoma
apxa	AnaplasticPleomorphicXanthoastrocytoma
armm	AnorectalMucosalMelanoma
arms	AlveolarRhabdomyosarcoma
asct	AdenosquamousCarcinomaoftheTongue
asm	AggressiveSystemicMastocytosis
asps	AlveolarSoftPartSarcoma
astb	Astroblastoma
astr	Astrocytoma
atll	AdultT-CellLeukemia/Lymphoma
atm	AtypicalMeningioma
atrt	AtypicalTeratoid/RhabdoidTumor
aul	AcuteUndifferentiatedLeukemia
awdnet	Well-DifferentiatedNeuroendocrineTumoroftheAppendix
awm	AMLwithoutMaturation
ba	BreastAngiosarcoma
bcc	BasalCellCarcinoma
bcca	Choriocarcinoma
bclu	B-CellLymphoma,Unclassifiable,withFeaturesIntermediatebetweenDLBCLandClassicalHodgkinlymphoma
bec	EmbryonalCarcinoma
bfn	BreastFibroepithelialNeoplasms
bgct	GermCellTumor,Brain
bialcl	BreastImplant-AssociatedAnaplasticLarge-CellLymphoma
biliary_tract	BiliaryTract
bimt	ImmatureTeratoma
bl	BurkittLymphoma
blad	BladderAdenocarcinoma
bladder	Bladder/UrinaryTract
blca	BladderUrothelialCarcinoma
blclc	BasaloidLargeCellCarcinomaoftheLung
bll	B-LymphoblasticLeukemia/Lymphoma
bll11q	Burkitt-LikeLymphomawith11qAberration
bllbcrabl1	B-LymphoblasticLeukemia/Lymphomawitht(9;22)(q34.1;q11.2);BCR-ABL1
bllbcrabl1l	B-LymphoblasticLeukemia/Lymphoma,BCR-ABL1Like
blletv6runx1	B-LymphoblasticLeukemia/Lymphomawitht(12;21)(p13.2;q22.1);ETV6-RUNX1
bllhyper	B-LymphoblasticLeukemia/LymphomawithHyperdiploidy
bllhypo	B-LymphoblasticLeukemia/LymphomawithHypodiploidy
blliamp21	B-LymphoblasticLeukemia/LymphomawithiAMP21
bllil3igh	B-LymphoblasticLeukemia/Lymphomawitht(5;14)(q31.1;q32.3)IL3-IGH
bllkmt2a	B-LymphoblasticLeukemia/Lymphomawitht(v;11q23.3);KMT2ARearranged
bllnos	B-LymphoblasticLeukemia/Lymphoma,NOS
bllrga	B-LymphoblasticLeukemia/LymphomawithRecurrentGeneticAbnormalities
blltcf3pbx1	B-LymphoblasticLeukemia/Lymphomawitht(1;19)(q23;p13.3);TCF3-PBX1
blpt	BorderlinePhyllodesTumoroftheBreast
blsc	BladderSquamousCellCarcinoma
bmgct	MixedGermCellTumor
bmgt	MalignantTeratoma
bmt	MatureTeratoma
bnnos	BreastNeoplasm,NOS
bone	Bone
bowel	Bowel
bpdcn	BlasticPlasmacytoidDendriticCellNeoplasm
bpll	B-CellProlymphocyticLeukemia
bpscc	BasaloidPenileSquamousCellCarcinoma
bpt	BenignPhyllodesTumoroftheBreast
brain	CNS/Brain
brame	AdenomyoepitheliomaoftheBreast
brca	InvasiveBreastCarcinoma
brcanos	BreastInvasiveCancer,NOS
brcnos	BreastInvasiveCarcinoma,NOS
breast	Breast
brsrcc	BreastCarcinomawithSignetRing
btbeov	BrennerTumor,Benign
btbov	BrennerTumor,Borderline
btmov	BrennerTumor,Malignant
btov	BrennerTumor
byst	YolkSacTumor
cabc	CervicalAdenoidBasalCarcinoma
cacc	CervicalAdenoidCysticCarcinoma
cais	ColonAdenocarcinomaInSitu
ccbov	ClearCellBorderlineOvarianTumor
cce	ClearCellEpendymoma
cchdm	ConventionalTypeChordoma
cchm	CarcinomawithChondroidMetaplasia
cclc	ClearCellCarcinomaoftheLung
ccm	ClearcellMeningioma
ccoc	ClearCellOdontogenicCarcinoma
ccov	ClearCellOvarianCancer
ccprc	ClearCellPapillaryRenalCellCarcinoma
ccrcc	RenalClearCellCarcinoma
ccs	ClearCellSarcoma
ccsk	ClearCellSarcomaofKidney
cdrcc	CollectingDuctRenalCellCarcinoma
cead	CervicalAdenocarcinoma
ceais	CervicalAdenocarcinomaInSitu
ceas	CervicalAdenosquamousCarcinoma
cecc	CervicalClearCellCarcinoma
ceen	CervicalEndometrioidCarcinoma
cegcc	GlassyCellCarcinomaoftheCervix
celi	CervicalLeiomyosarcoma
celnos	ChronicEosinophilicLeukemia,NOS
cemn	MesonephricCarcinoma
cemu	MucinousCarcinoma
cene	CervicalNeuroendocrineTumor
cerms	CervicalRhabdomyosarcoma
cervix	Cervix
cesc	CervicalSquamousCellCarcinoma
cese	CervicalSerousCarcinoma
cevg	VilloglandularCarcinoma
chbl	Chondroblastoma
chdm	Chordoma
chgl	ChordoidGliomaoftheThirdVentricle
chl	ClassicalHodgkinLymphoma
chlptld	ClassicalHodgkinLymphomaPTLD
chm	CompleteHydatidiformMole
chol	Cholangiocarcinoma
chom	ChordoidMeningioma
chos	ChondroblasticOsteosarcoma
chrcc	ChromophobeRenalCellCarcinoma
chs	Chondrosarcoma
cllsll	ChronicLymphocyticLeukemia/SmallLymphocyticLymphoma
clnc	CerebellarLiponeurocytoma
clpdnk	ChronicLymphoproliferativeDisorderofNKCells
cm	ConjunctivalMelanoma
cmc	MedullaryCarcinomaoftheColon
cmcd	CutaneousMastocytosis
cml	ChronicMyelogenousLeukemia
cmlbcrabl1	ChronicMyeloidLeukemia,BCR-ABL1+
cmml	ChronicMyelomonocyticLeukemia
cmml0	ChronicMyelomonocyticLeukemia-0
cmml1	ChronicMyelomonocyticLeukemia-1
cmml2	ChronicMyelomonocyticLeukemia-2
cmpt	CiliatedMuconodularPapillaryTumoroftheLung
cnc	CentralNeurocytoma
cnl	ChronicNeutrophilicLeukemia
coad	ColonAdenocarcinoma
coadread	ColorectalAdenocarcinoma
com	CarcinomawithOsseousMetaplasia
cpc	ChoroidPlexusCarcinoma
cpp	ChoroidPlexusPapilloma
cpt	ChoroidPlexusTumor
cscc	CutaneousSquamousCellCarcinoma
cschw	CellularSchwannoma
csclc	CombinedSmallCellLungCarcinoma
csnos	BreastInvasiveCarcinosarcoma,NOS
ctaap	ColonicTypeAdenocarcinomaoftheAppendix
cup	CancerofUnknownPrimary
cupnos	CancerofUnknownPrimary,NOS
da	DuodenalAdenocarcinoma
dastr	DiffuseAstrocytoma
dcis	BreastDuctalCarcinomaInSitu
dcs	DendriticCellSarcoma
ddchdm	DedifferentiatedChordoma
ddchs	DedifferentiatedChondrosarcoma
ddls	DedifferentiatedLiposarcoma
des	Desmoid/AggressiveFibromatosis
desm	DesmoplasticMelanoma
df	Dermatofibroma
dfl	Duodenal-TypeFollicularLymphoma
dfsp	DermatofibrosarcomaProtuberans
dia	DesmoplasticInfantileAstrocytoma
difg	DiffuseGlioma
dig	DesmoplasticInfantileGanglioglioma
dipg	DiffuseIntrinsicPontineGlioma
dlbclci	DLBCLAssociatedwithChronicInflammation
dlbclnos	DiffuseLargeB-CellLymphoma,NOS
dmbl	Desmoplastic/NodularMedulloblastoma
dnt	DysembryoplasticNeuroepithelialTumor
dsrct	DesmoplasticSmall-Round-CellTumor
dstad	DiffuseTypeStomachAdenocarcinoma
dte	DesmoplasticTrichoepithelioma
eatl	Enteropathy-AssociatedT-CellLymphoma
ebov	EndometrioidBorderlinOvarianTumor
ebvdlbclnos	EBVPositiveDLBCL,NOS
ebvmcu	EBVPositiveMucocutaneousUlcer
ecad	EndocervicalAdenocarcinoma
ecd	Erdheim-ChesterDisease
egc	EsophagogastricAdenocarcinoma
egct	ExtraGonadalGermCellTumor
ehae	EpithelioidHemangioendothelioma
ehch	ExtrahepaticCholangiocarcinoma
emalt	ExtranodalMarginalZoneLymphomaofMucosa-AssociatedLymphoidTissue(MALTlymphoma)
embc	EpithelialTypeMetaplasticBreastCancer
embca	EmbryonalCarcinoma
embt	EmbryonalTumor
emchs	ExtraskeletalMyxoidChondrosarcoma
empd	ExtramammaryPagetDisease
empsgc	EndocrineMucinProducingSweatGlandCarcinoma
emyoca	Epithelial-MyoepithelialCarcinoma
encg	EncapsulatedGlioma
enkl	ExtranodalNK-/T-CellLymphoma,NasalType
eov	EndometrioidOvarianCancer
ep	ExtraosseousPlasmacytoma
epdca	EsophagealPoorlyDifferentiatedCarcinoma
epis	EpithelioidSarcoma
epm	Ependymoma
epmt	EpendymomalTumor
erms	EmbryonalRhabdomyosarcoma
es	EwingSarcoma
esca	EsophagealAdenocarcinoma
escc	EsophagealSquamousCellCarcinoma
esmm	MucosalMelanomaoftheEsophagus
ess	EndometrialStromalSarcoma
esst	EwingSarcomaofSoftTissue
et	EssentialThrombocythemia
etantr	EmbryonalTumorwithAbundantNeuropilandTrueRosettes
etmf	EssentialThrombocythemiaMyelofibrosis
etpll	EarlyT-CellPrecursorLymphoblasticLeukemia
ett	EpithelioidTrophoblasticTumor
evn	ExtraventricularNeurocytoma
eye	Eye
fa	Fibroadenoma
fdcs	FollicularDendriticCellSarcoma
fhptld	FloridFollicularHyperplasiaPTLD
fhrcc	FH-DeficientRenalCellCarcinoma
fibs	Fibrosarcoma
fios	FibroblasticOsteosarcoma
fl	FollicularLymphoma
flc	FibrolamellarCarcinoma
frct	FibroblasticReticularCellTumor
ft	Fibrothecoma
ftcl	FollicularT-CellLymphoma
gb	Glioblastoma
gbad	GallbladderAdenocarcinoma,NOS
gbasc	AdenosquamousCarcinomaoftheGallbladder
gbc	GallbladderCancer
gbm	GlioblastomaMultiforme
gcb	GerminalCenterB-CellType
gccap	GobletCellCarcinoidoftheAppendix
gcemu	GastricTypeMucinousCarcinoma
gclc	GiantCellCarcinomaoftheLung
gct	GranularCellTumor
gctb	GiantCellTumorofBone
gej	AdenocarcinomaoftheGastroesophagealJunction
ghcd	GammaHeavy-ChainDisease
ginet	GastrointestinalNeuroendocrineTumors
ginetes	GastrointestinalNeuroendocrineTumorsoftheEsophagus/Stomach
gist	GastrointestinalStromalTumor
gmn	Germinoma
gn	Ganglioneuroma
gnbl	Ganglioneuroblastoma
gnc	Gangliocytoma
gng	Ganglioglioma
gnos	Glioma,NOS
grc	GastricRemnantAdenocarcinoma
grct	GranulosaCellTumor
gs	Glomangiosarcoma
gsarc	Gliosarcoma
gtd	GestationalTrophoblasticDisease
hcc	HepatocellularCarcinoma
hccihch	HepatocellularCarcinomaplusIntrahepaticCholangiocarcinoma
hcl	HairyCellLeukemia
hcl-v	HairyCellLeukemia-Variant
hdcn	HistiocyticandDendriticCellNeoplasms
hdcs	HistiocyticDendriticCellSarcoma
head_neck	HeadandNeck
hema	Hemangioma
hgbcl	High-GradeB-CellLymphoma,NOS
hgbclmycbcl2	High-GradeB-CellLymphoma,withMYCandBCL2and/orBCL6Rearrangements
hgess	High-GradeEndometrialStromalSarcoma
hggnos	High-GradeGlioma,NOS
hgnec	High-GradeNeuroendocrineCarcinomaoftheColonandRectum
hgnee	High-GradeNeuroendocrineCarcinomaoftheEsophagus
hgnes	High-GradeNeuroendocrineCarcinomaoftheStomach
hgnet	High-GradeNeuroepithelialTumor
hgonec	High-GradeNeuroendocrineCarcinomaoftheOvary
hgsft	High-GradeSerousFallopianTubeCancer
hgsoc	High-GradeSerousOvarianCancer
hgsos	High-GradeSurfaceOsteosarcoma
hhv8dlbcl	HHV8PositiveDLBCL,NOS
hl	HodgkinLymphoma
hmbl	Hemangioblastoma
hnmasc	MammaryAnalogueSecretoryCarcinomaofSalivaryGlandOrigin
hnmucm	HeadandNeckMucosalMelanoma
hnne	HeadandNeckNeuroendocrineCarcinoma
hnsc	HeadandNeckSquamousCellCarcinoma
hnscup	HeadandNeckSquamousCellCarcinomaofUnknownPrimary
hpccns	HemangiopericytomaoftheCentralNervousSystem
hphsc	HypopharynxSquamousCellCarcinoma
hs	HistiocyticSarcoma
hstcl	HepatosplenicT-cellLymphoma
htat	HyalinizingTrabecularAdenomaoftheThyroid
hvll	HydroaVacciniformeLikeLymphoproliferativeDisorder
iampca	IntestinalAmpullaryCarcinoma
ibc	InflammatoryBreastCancer
icemu	IntestinalTypeMucinousCarcinoma
idc	BreastInvasiveDuctalCarcinoma
idcs	InterdigitatingDendriticCellSarcoma
idct	IndeterminateDendriticCellTumor
ifs	InfantileFibrosarcoma
ihch	IntrahepaticCholangiocarcinoma
ihm	InvasiveHydatidiformMole
ilc	BreastInvasiveLobularCarcinoma
immc	BreastInvasiveMixedMucinousCarcinoma
imptld	InfectiousMononucleosisPTLD
ims	Myofibromatosis
imt	InflammatoryMyofibroblasticTumor
imtb	InflammatoryMyofibroblasticBladderTumor
imtl	InflammatoryMyofibroblasticLungTumor
ints	IntimalSarcoma
ipmn	IntraductalPapillaryMucinousNeoplasm
isfn	InSituFollicularNeoplasia
ism	IndolentSystemicMastocytosis
ismcl	InSituMantleCellNeoplasia
istad	IntestinalTypeStomachAdenocarcinoma
itlpdgi	IndolentT-CellLymphoproliferativeDisorderoftheGITract
iup	InvertedUrothelialPapilloma
ivbcl	IntravascularLargeB-CellLymphoma
jmml	JuvenileMyelomonocyticLeukemia
jscb	JuvenileSecretoryCarcinomaoftheBreast
jxg	DisseminatedJuvenileXanthogranuloma
kidney	Kidney
lais	LungAdenocarcinomaInSitu
lam	PulmonaryLymphangiomyomatosis
latl	LymphoidAtypical
lbgn	LymphoidBenign
lblirf4	LargeB-CellLymphomawithIRF4Rearrangement
lch	LangerhansCellHistiocytosis
lcis	BreastLobularCarcinomaInSitu
lclc	LargeCellLungCarcinoma
lcs	LangerhansCellSarcoma
ldchl	Lymphocyte-DepletedClassicalHodgkinLymphoma
ldd	DysplasticGangliocytomaoftheCerebellum/Lhermitte-DuclosDisease
leclc	Lymphoepithelioma-likeCarcinomaoftheLung
lgcos	Low-GradeCentralOsteosarcoma
lgess	Low-GradeEndometrialStromalSarcoma
lgfms	Low-GradeFibromyxoidSarcoma
lggnos	Low-GradeGlioma,NOS
lgnet	Low-GradeNeuroepithelialTumor
lgsoc	Low-GradeSerousOvarianCancer
liad	HepatocellularAdenoma
lias	LiverAngiosarcoma
lihb	Hepatoblastoma
limnet	MalignantNonepithelialTumoroftheLiver
lipo	Liposarcoma
liver	Liver
lms	Leiomyosarcoma
lnet	LungNeuroendocrineTumor
lnm	LymphoidNeoplasm
lpl	LymphoplasmacyticLymphoma
lrchl	Lymphocyte-RichClassicalHodgkinLymphoma
luacc	AdenoidCysticCarcinomaoftheLung
luad	LungAdenocarcinoma
luas	LungAdenosquamousCarcinoma
luca	LungCarcinoid
lumec	MucoepidermoidCarcinomaoftheLung
lune	LargeCellNeuroendocrineCarcinoma
lung	Lung
lupc	PleomorphicCarcinomaoftheLung
lusc	LungSquamousCellCarcinoma
lxsc	LarynxSquamousCellCarcinoma
lyg	LymphomatoidGranulomatosis
lymph	Lymphoid
lyp	LymphomatoidPapulosis
maap	MucinousAdenocarcinomaoftheAppendix
mac	MicrocysticAdnexalCarcinoma
macr	MucinousAdenocarcinomaoftheColonandRectum
mampca	MixedAmpullaryCarcinoma
masc	MetaplasticAdenosquamousCarcinoma
mascc	MetaplasticAdenocarcinomawithSpindleCellDifferentiation
matpl	MyeloidAtypical
mbc	MetaplasticBreastCancer
mben	MedulloblastomawithExtensiveNodularity
mbgn	MyeloidBenign
mbl	Medulloblastoma
mbn	MatureB-CellNeoplasms
mbov	MucinousBorderlineOvarianTumor
mbt	MiscellaneousBrainTumor
mcbcl	MonoclonalB-CellLymphocytosis
mcc	MerkelCellCarcinoma
mcce	MixedCervicalCarcinoma
mcchl	MixedCellularityClassicalHodgkinLymphoma
mcd	Mastocytosis
mchs	MesenchymalChondrosarcoma
mchscns	MesenchymalChondrosarcomaoftheCNS
mcl	MantleCellLymphoma
mcn	MucinousCysticNeoplasm
mcs	MetaplasticCarcinosarcoma
mcsl	MastCellSarcoma
mdep	Medulloepithelioma
mdlc	BreastMixedDuctalandLobularCarcinoma
mds	MyelodysplasticSyndromes
mds/mpn	Myelodysplastic/MyeloproliferativeNeoplasms
mdseb	MDSwithExcessBlasts
mdseb1	MDSwithexcessblasts-1
mdseb2	MDSwithexcessblasts-2
mdsid5q	MDSwithIsolatedDel(5q)
mdsmd	MDSwithMultilineageDysplasia
mdsmpnrst	MDS/MPNwithRingSideroblastsandThrombocytosis
mdsmpnu	MDS/MPN,Unclassifiable
mdsrs	MDSwithRingSideroblasts
mdsrsmd	MDSwithRingSideroblastsandMultilineageDysplasia
mdsrssld	MDSwithRingSideroblastsandSingleLineageDysplasia
mdssld	MDSwithSingleLineageDysplasia
mdsu	MDS,Unclassifiable
meatl	MonomorphicEpitheliotropicIntestinalT-CellLymphoma
mel	Melanoma
melc	Melanocytoma
mf	Myofibroma
mfh	UndifferentiatedPleomorphicSarcoma/MalignantFibrousHistiocytoma/High-GradeSpindleCellSarcoma
mfs	Myxofibrosarcoma
mgct	MixedGermCellTumor
mgst	MalignantGlomusTumor
mgus	MonoclonalGammopathyofUndeterminedSignificance
mgusiga	IgA
mgusigg	IgG
mgusigm	IgM
mhcd	MuHeavy-ChainDisease
midd	MonoclonalImmunoglobulinDepositionDiseases
midda	Amyloidosis
middo	MonoclonalImmunoglobulinDepositionDiseases,Other
mixed	MixedCancerTypes
mlads	MyeloidLeukemiaAssociatedwithDownSyndrome
mlner	Myeloid/LymphoidNeoplasmswithEosinophiliaandRearrangementofPDGFRA/PDGFRBorFGFR1orwithPCM1-JAK2
mlnfgfr1	Myeloid/LymphoidNeoplasmswithFGFR1Rearrangement
mlnpcm1jak2	Myeloid/LymphoidNeoplasmswithPCM1-JAK2
mlnpdgfra	Myeloid/LymphoidNeoplasmswithPDGFRARearrangement
mlnpdgfrb	Myeloid/LymphoidNeoplasmswithPDGFRBRearrangement
mlym	MalignantLymphoma
mmb	Medullomyoblastoma
mmbc	MixedTypeMetaplasticBreastCancer
mmbl	MelanoticMedulloblastoma
mnet	MiscellaneousNeuroepithelialTumor
mng	Meningioma
mnglp	MyeloidNeoplasmswithGermLinePredisposition
mngt	MeningothelialTumor
mnm	MyeloidNeoplasm
mov	MucinousOvarianCancer
mp	MolarPregnancy
mpalbcrabl1	MixedPhenotypeAcuteLeukemiawitht(9;22)(q34.1;q11.2);BCR-ABL1
mpalbnos	MixedPhenotypeAcuteLeukemia,B/Myeloid,NOS
mpalkmt2a	MixedPhenotypeAcuteLeukemiawitht(v;11q23.3);KMT2ARearranged
mpaltnos	MixedPhenotypeAcuteLeukemia,T/Myeloid,NOS
mpc	Myopericytoma
mpe	MyxopapillaryEpendymoma
mpn	MyeloproliferativeNeoplasms
mpnst	MalignantPeripheralNerveSheathTumor
mpnu	MyeloproliferativeNeoplasms,Unclassifiable
mprds	MyeloidProliferationsRelatedtoDownSyndrome
mpt	MalignantPhyllodesTumoroftheBreast
mptld	MonomorphicPTLD(B-andT-/NK-celltypes)
mrc	RenalMedullaryCarcinoma
mrls	Myxoid/Round-CellLiposarcoma
mrt	RhabdoidCancer
mrtl	MalignantRhabdoidTumoroftheLiver
ms	MyeloidSarcoma
mscc	MetaplasticSquamousCellCarcinoma
mschw	MelanoticSchwannoma
mstad	MucinousStomachAdenocarcinoma
mt	MalignantTumor
mtnn	MatureTandNKNeoplasms
mtscc	RenalMucinousTubularSpindleCellCarcinoma
mucc	MucoepidermoidCarcinoma
mup	MelanomaofUnknownPrimary
mxov	MixedOvarianCarcinoma
mycf	MycosisFungoides
mychs	MyxoidChondrosarcoma
myec	MyoepithelialCarcinoma
myeloid	Myeloid
myxo	Myxoma
mzl	MarginalZoneLymphoma
nbl	Neuroblastoma
nccrcc	RenalNon-ClearCellCarcinoma
necnos	NeuroendocrineCarcinoma,NOS
netnos	NeuroendocrineTumor,NOS
nfib	Neurofibroma
nhl	Non-HodgkinLymphoma
nkcll	NaturalKiller(NK)CellLymphoblasticLeukemia/Lymphoma
nlphl	NodularLymphocyte-PredominantHodgkinLymphoma
nmchn	NUTMidlineCarcinomaoftheHeadandNeck
nmzl	NodalMarginalZoneLymphoma
npc	NasopharyngealCarcinoma
nptltfh	NodalPeripheralT-CellLymphomawithTFHPhenotype
nschl	NodularSclerosisClassicalHodgkinLymphoma
nsclc	Non-SmallCellLungCancer
nsclcpd	PoorlyDifferentiatedNon-SmallCellLungCancer
nsgct	Non-SeminomatousGermCellTumor
nst	NerveSheathTumor
oast	Oligoastrocytoma
oat	OncocyticAdenomaoftheThyroid
ocnos	OvarianChoriocarcinoma,NOS
ocs	OvarianCarcinosarcoma/MalignantMixedMesodermalTumor
ocsc	OralCavitySquamousCellCarcinoma
odg	Oligodendroglioma
odgc	OdontogenicCarcinoma
odys	Dysgerminoma
oec	EmbryonalCarcinoma
ofmt	OssifyingFibromyxoidTumor
ogbl	Gonadoblastoma
ogct	OvarianGermCellTumor
ohnca	HeadandNeckCarcinoma,Other
oimt	ImmatureTeratoma
om	OcularMelanoma
omgct	MixedGermCellTumor
omt	MatureTeratoma
onbl	OlfactoryNeuroblastoma
oovc	OvarianCancer,Other
ope	Polyembryoma
ophsc	OropharynxSquamousCellCarcinoma
os	Osteosarcoma
osaca	SalivaryCarcinoma,Other
osgct	OsteoclasticGiantCellTumor
osmad	OvarianSeromucinousAdenoma
osmbt	OvarianSeromucinousBorderlineTumor
osmca	OvarianSeromucinousCarcinoma
osos	OsteoblasticOsteosarcoma
other	Other
ousarc	UterineSarcoma,Other
outt	OtherUterineTumor
ovary	Ovary/FallopianTube
ovt	OvarianEpithelialTumor
oyst	YolkSacTumor
paac	AcinarCellCarcinomaofthePancreas
paad	PancreaticAdenocarcinoma
paasc	AdenosquamousCarcinomaofthePancreas
pact	CysticTumorofthePancreas
pampca	PancreatobiliaryAmpullaryCarcinoma
pancreas	Pancreas
panet	PancreaticNeuroendocrineTumor
paos	ParostealOsteosarcoma
past	PilocyticAstrocytoma
pb	Pancreatoblastoma
pbl	Pineoblastoma
pbs	BreastSarcoma
pbt	PrimaryBrainTumor
pcaectcl	PrimaryCutaneousCD8PositiveAggressiveEpidermotropicCytotoxicT-CellLymphoma
pcalcl	PrimaryCutaneousAnaplasticLargeCellLymphoma
pcatcl	PrimaryCutaneousAcralCD8PositiveT-CellLymphoma
pcfcl	PrimaryCutaneousFollicleCenterLymphoma
pcgdtcl	PrimaryCutaneousGammaDeltaT-CellLymphoma
pcgp	Craniopharyngioma,PapillaryType
pclbcllt	PrimaryCutaneousDLBCL,LegType
pclpd	PrimaryCutaneousCD30PositiveT-CellLymphoproliferativeDisorders
pcm	PlasmaCellMyeloma
pcnsl	PrimaryDLBCLofthecentralnervoussystem
pcnsm	PrimaryCNSMelanoma
pcnsmt	PrimaryCNSMelanocyticTumors
pcsmtpld	PrimaryCutaneousCD4PositiveSmall/MediumT-CellLymphoproliferativeDisorder
pct	PorphyriaCutaniaTarda
pd	PagetDiseaseoftheNipple
pdc	PoorlyDifferentiatedCarcinoma,NOS
pecoma	PerivascularEpithelioidCellTumor
pel	PrimaryEffusionLymphoma
pemeso	PeritonealMesothelioma
penis	Penis
peos	PeriostealOsteosarcoma
peritoneum	Peritoneum
perl	PureErythroidLeukemia
pgng	Paraganglioma
pgnt	PapillaryGlioneuronalTumor
phc	Pheochromocytoma
phch	PerihilarCholangiocarcinoma
phm	PartialHydatidiformMole
phptld	PlasmacyticHyperplasiaPTLD
pinc	Pineocytoma
pint	PinealTumor
plbl	PlasmablasticLymphoma
plbmeso	PleuralMesothelioma,BiphasicType
plemeso	PleuralMesothelioma,EpithelioidType
pleura	Pleura
plls	PleomorphicLiposarcoma
plmeso	PleuralMesothelioma
plrms	PleomorphicRhabdomyosarcoma
plsmeso	PleuralMesothelioma,SarcomatoidType
pma	PilomyxoidAstrocytoma
pmbl	PrimaryMediastinal(Thymic)LargeB-CellLymphoma
pmf	PrimaryMyelofibrosis
pmfofs	PrimaryMyelofibrosis,OvertFibroticStage
pmfpes	PrimaryMyelofibrosis,Prefibrotic/EarlyStage
pmhe	PseudomyogenicHemangioendothelioma
pnet	PrimitiveNeuroectodermalTumor
pns	PeripheralNervousSystem
poca	Porocarcinoma/Spiroadenocarcinoma
poro	Poroma/Acrospiroma
ppb	PleuropulmonaryBlastoma
ppct	ProliferatingPilarCysticTumor
ppm	PapillaryMeningioma
pptid	PinealParenchymalTumorofIntermediateDifferentiation
pptld	PolymorphicPTLD
prad	ProstateAdenocarcinoma
prcc	PapillaryRenalCellCarcinoma
prne	ProstateNeuroendocrineCarcinoma
prnet	PrimaryNeuroepithelialTumor
prostate	Prostate
prsc	ProstateSquamousCellCarcinoma
prscc	ProstateSmallCellCarcinoma
psc	SerousCystadenomaofthePancreas
pscc	PenileSquamousCellCarcinoma
psec	PeritonealSerousCarcinoma
pstad	PapillaryStomachAdenocarcinoma
pstt	PlacentalSiteTrophoblasticTumor
pt	PhyllodesTumoroftheBreast
ptad	PituitaryAdenoma
ptca	PituitaryCarcinoma
ptcl	PeripheralT-Celllymphoma,NOS
ptcy	Pituicytoma
ptes	Proximal-TypeEpithelioidSarcoma
ptfl	Pediatric-TypeFollicularLymphoma
pth	ParathyroidCancer
pthc	ParathyroidCarcinoma
ptld	PosttransplantLymphoproliferativeDisorders
ptpr	PapillaryTumorofthePinealRegion
pv	PolycythemiaVera
pvmf	PolycythaemiaVeraMyelofibrosis
pxa	PleomorphicXanthoastrocytoma
raml	RenalAngiomyolipoma
ras	Radiation-AssociatedSarcoma
rbl	Retinoblastoma
rcc	RenalCellCarcinoma
rcsnos	RoundCellSarcoma,NOS
rcyc	RefractoryCytopeniaofChildhood
rdd	Rosai-DorfmanDisease
read	RectalAdenocarcinoma
rgnt	Rosette-formingGlioneuronalTumoroftheFourthVentricle
rhm	RhabdoidMeningioma
rlclc	LargeCellLungCarcinomaWithRhabdoidPhenotype
rms	Rhabdomyosarcoma
rnet	RenalNeuroendocrineTumor
rocy	RenalOncocytoma
rscc	RenalSmallCellCarcinoma
rwdnet	Well-DifferentiatedNeuroendocrineTumoroftheRectum
saad	SalivaryAdenocarcinoma
saca	SalivaryCarcinoma
sarcl	SarcomatoidCarcinomaoftheLung
sarcnos	Sarcoma,NOS
sbc	SmallBowelCancer
sbl	Sialoblastoma
sblu	SplenicB-CellLymphoma/Leukemia,Unclassifiable
sbmov	SerousBorderlineOvarianTumor,Micropapillary
sbov	SerousBorderlineOvarianTumor
sbwdnet	SmallBowelWell-DifferentiatedNeuroendocrineTumor
scb	SarcomatoidCarcinomaoftheUrinaryBladder
scbc	SmallCellBladderCancer
scce	SmallCellCarcinomaoftheCervix
sccnos	SquamousCellCarcinoma,NOS
scco	SmallCellCarcinomaoftheOvary
sccrcc	RenalClearCellCarcinomawithSarcomatoidFeatures
scemu	SignetRingMucinousCarcinoma
scgbc	SmallCellGallbladderCarcinoma
scgbm	SmallCellGlioblastoma
schw	Schwannoma
sclc	SmallCellLungCancer
scoah	SpindleCellOncocytomaoftheAdenohypophysis
scos	SmallCellOsteosarcoma
scrms	SpindleCellRhabdomyosarcoma
scsrms	SpindleCell/SclerosingRhabdomyosarcoma
scst	SexCordStromalTumor
sct	SteroidCellTumor,NOS
scup	SmallCellCarcinomaofUnknownPrimary
sdca	SalivaryDuctCarcinoma
sdrpl	SplenicDiffuseRedPulpSmallB-CellLymphoma
seba	SebaceousCarcinoma
sebvtlc	SystemicEBVPositiveT-CellLymphomaofChildhood
secos	SecondaryOsteosarcoma
sef	SclerosingEpithelioidFibrosarcoma
selt	SellarTumor
sem	Seminoma
sft	SolitaryFibrousTumor/Hemangiopericytoma
sftcns	SolitaryFibrousTumoroftheCentralNervousSystem
sgad	SweatGlandAdenocarcinoma
sgo	SalivaryGlandOncocytoma
sgttl	SalivaryGland-TypeTumoroftheLung
sic	SmallIntestinalCarcinoma
skac	SkinAdnexalCarcinoma
skcm	CutaneousMelanoma
skcn	CongenitalNevus
skin	Skin
sklmm	LentigoMalignaMelanoma
slct	Sertoli-LeydigCellTumor
sm	SystemicMastocytosis
smahn	SystemicMastocytosiswithanAssociatedHematologicalNeoplasm
smmcl	MastCellLeukemia
smn	SmoothMuscleNeoplasm,NOS
smzl	SplenicMarginalZoneLymphoma
sna	SinonasalAdenocarcinoma
snsc	SinonasalSquamousCellCarcinoma
snuc	SinonasalUndifferentiatedCarcinoma
soc	SerousOvarianCancer
soft_tissue	SoftTissue
spb	SolitaryPlasmacytomaofBone
spc	SolidPapillaryCarcinomaoftheBreast
spcc	SpindleCellCarcinomaoftheLung
spdac	PoorlyDifferentiatedCarcinomaoftheStomach
spir	Spiroma/Spiradenoma
spn	SolidPseudopapillaryNeoplasmofthePancreas
sptcl	SubcutaneousPanniculitis-LikeT-CellLymphoma
spzm	SpitzoidMelanoma
srap	SignetRingCellTypeoftheAppendix
srcbc	Plasmacytoid/SignetRingCellBladderCarcinoma
srcc	SarcomatoidRenalCellCarcinoma
srccr	SignetRingCellAdenocarcinomaoftheColonandRectum
ss	SezarySyndrome
ssm	SmolderingSystemicMastocytosis
ssrcc	SignetRingCellCarcinomaoftheStomach
stad	StomachAdenocarcinoma
stas	AdenosquamousCarcinomaoftheStomach
stmyec	SoftTissueMyoepithelialCarcinoma
stomach	Esophagus/Stomach
stsc	SmallCellCarcinomaoftheStomach
sube	Subependymoma
swdnet	Well-DifferentiatedNeuroendocrineTumorsoftheStomach
syns	SynovialSarcoma
tac	TubularAdenomaoftheColon
tam	TransientAbnormalMyelopoiesis
taml	Therapy-RelatedAcuteMyeloidLeukemia
tcca	Choriocarcinoma
teos	TelangiectaticOsteosarcoma
testis	Testis
tet	ThymicEpithelialTumor
tgct	TenosynovialGiantCellTumorDiffuseType
thap	AnaplasticThyroidCancer
thfo	FollicularThyroidCancer
thhc	HurthleCellThyroidCancer
thme	MedullaryThyroidCancer
thpa	PapillaryThyroidCancer
thpd	PoorlyDifferentiatedThyroidCancer
thrlbcl	T-Cell/Histiocyte-RichLargeB-CellLymphoma
thyc	ThymicCarcinoma
thym	Thymoma
thymus	Thymus
thyroid	Thyroid
tlgl	T-CellLargeGranularLymphocyticLeukemia
tll	T-LymphoblasticLeukemia/Lymphoma
tlym	TesticularLymphoma
tmds	Therapy-RelatedMyelodysplasticSyndrome
tmeso	TesticularMesothelioma
tmn	Therapy-RelatedMyeloidNeoplasms
tmt	TeratomawithMalignantTransformation
tnet	ThymicNeuroendocrineTumor
tpll	T-CellProlymphocyticLeukemia
trcc	Translocation-AssociatedRenalCellCarcinoma
tscst	SexCordStromalTumor
tstad	TubularStomachAdenocarcinoma
tt	Teratoma
tyst	YolkSacTumor
ua	UrachalAdenocarcinoma
uad	UrethralAdenocarcinoma
uas	UterineAdenosarcoma
uasc	UterineAdenosquamousCarcinoma
uca	UrethralCancer
ucca	Choriocarcinoma
uccc	UterineClearCellCarcinoma
ucec	EndometrialCarcinoma
ucp	UndifferentiatedCarcinomaofthePancreas
ucs	UterineCarcinosarcoma/UterineMalignantMixedMullerianTumor
ucu	UrethralUrothelialCarcinoma
uddc	UterineDedifferentiatedCarcinoma
udmn	UndifferentiatedMalignantNeoplasm
uec	UterineEndometrioidCarcinoma
uelms	UterineEpithelioidLeiomyosarcoma
uesl	UndifferentiatedEmbryonalSarcomaoftheLiver
ulm	UterineLeiomyoma
ulms	UterineLeiomyosarcoma
um	UvealMelanoma
umc	UterineMucinousCarcinoma
umec	UterineMixedEndometrialCarcinoma
umlms	UterineMyxoidLeiomyosarcoma
umnc	UterineMesonephricCarcinoma
unec	UterineNeuroendocrineCarcinoma
upa	UrothelialPapilloma
updc	PoorlyDifferentiatedCarcinomaoftheUterus
upecoma	UterinePerivascularEpithelioidCellTumor
urca	UrachalCarcinoma
urcc	UnclassifiedRenalCellCarcinoma
urmm	MucosalMelanomaoftheUrethra
usarc	UterineSarcoma/Mesenchymal
usc	UterineSerousCarcinoma/UterinePapillarySerousCarcinoma
uscc	UrethralSquamousCellCarcinoma
usmt	UterineSmoothMuscleTumor
ustad	UndifferentiatedStomachAdenocarcinoma
ustump	UterineSmoothMuscleTumorofUncertainMalignantPotential
uterus	Uterus
utuc	UpperTractUrothelialCarcinoma
uuc	UterineUndifferentiatedCarcinoma
uus	UndifferentiatedUterineSarcoma
va	VaginalAdenocarcinoma
vdys	Dysgerminoma
vgce	VilloglandularAdenocarcinomaoftheCervix
vgct	GermCellTumoroftheVulva
vimt	ImmatureTeratoma
vma	MucinousAdenocarcinomaoftheVulva/Vagina
vmgct	MixedGermCellTumor
vmm	MucosalMelanomaoftheVulva/Vagina
vmt	MatureTeratoma
voec	EmbryonalCarcinoma
vpdc	PoorlyDifferentiatedVaginalCarcinoma
vpe	Polyembryoma
vpscc	VerrucousPenileSquamousCellCarcinoma
vsc	SquamousCellCarcinomaoftheVulva/Vagina
vulva	Vulva/Vagina
vyst	YolkSacTumor
wdls	Well-DifferentiatedLiposarcoma
wdtc	Well-DifferentiatedThyroidCancer
wm	WaldenstromMacroglobulinemia
wpscc	WartyPenileSquamousCellCarcinoma
wt	Wilms'Tumor